*▅▅▅▅▅▅▅▅▅▅▅▅▅▅▅▅▅▅▅▅▅▅▅▅▅▅▅▅▅▅▅▅▅▅▅▅▅▅▅▅▅▅▅▅▅▅▅▅▅*
▉ • • • • • • ▉ • • • • • • • • • • ▉ • • • • • • ▉
▉ ⚫ ▅▅▅▅▅▅▅ • ▉ • ▅▅▅▅▅▅▅▅▅▅▅▅▅▅▅ • ▉ • ▅▅▅▅▅▅▅ ⚫ ▉
▉ • • • • • • • • • • • • • • • • • • • • • • • • ▉
*▅▅▅▅▅▅ • ▉ • ▉▉▉▉▉▉▉ • ▉▉▉ • ▉▉▉▉▉▉▉ • ▉ • ▅▅▅▅▅▅*
*     ▉ • ▉ • ▉▉▉▉▉▉▉ • ▉▉▉ • ▉▉▉▉▉▉▉ • ▉ • ▉     *
▅▅▅▅▅▅▅ • ▉ • ▉▉▉▉▉▉▉ • ▉▉▉ • ▉▉▉▉▉▉▉ • ▉ • ▅▅▅▅▅▅▅
• • • • • ▉ • • • • • • ▉▉▉ • • • • • • ▉ • • • • •
▅▅▅▅▅▅▅ • ▉▅▅▅▅▅▅ • ▅▅▅▅▉▉▉▅▅▅▅ • ▅▅▅▅▅▅▉ • ▅▅▅▅▅▅▅
*     ▉ • • • • • • • • • • • • • • • • • • ▉     *
*     ▉ • ▉▉▉▉▉▉▉ • ▅▅▅▅━━━▅▅▅▅ • ▉▉▉▉▉▉▉ • ▉     *
*     ▉ • ▉ • • • • ▉         ▉ • • • • ▉ • ▉     *
▅▅▅▅▅▅▉ • ▉ • ▉▉▉ • ▉▅▅▅▅▅▅▅▅▅▉ • ▉▉▉ • ▉ • ▉▅▅▅▅▅▅
• • • • • • • ▉▉▉ • • • • • • • • ▉▉▉ • • • • • • •
▅▅▅▅▅▅▅ • ▅▅▅▅▉▉▉▅▅▅▅ • ▉▉▉ • ▅▅▅▅▉▉▉▅▅▅▅ • ▅▅▅▅▅▅▅
*     ▉ • • • • • • • • ▉▉▉ • • • • • • • • ▉     *
▅▅▅▅▅▅▉ • ▅▅▅▅▅▅▅ • ▅▅▅▅▉▉▉▅▅▅▅ • ▅▅▅▅▅▅▅ • ▉▅▅▅▅▅▅
▉ • • • • • • • • • • • • • • • • • • • • • • • • ▉
▉ • ▉▉▉▉▉▉▉▉▉ • ▅▅▅▅▅ • ▉▉▉ • ▅▅▅▅▅ • ▉▉▉▉▉▉▉▉▉ • ▉
▉ • ▉▉▉▉▉▉▉▉▉ • ▉ • • • ▉▉▉ • • • ▉ • ▉▉▉▉▉▉▉▉▉ • ▉
▉ ⚫ ▉▉▉▉▉▉▉▉▉ • ▉ • ▅▅▅▅▉▉▉▅▅▅▅ • ▉ • ▉▉▉▉▉▉▉▉▉ ⚫ ▉
▉ • • • • • • • • • • • • • • • • • • • • • • • • ▉
▉▅▅▅▅▅▅▅▅▅▅▅▅▅▅▅▅▅▅▅▅▅▅▅▅▅▅▅▅▅▅▅▅▅▅▅▅▅▅▅▅▅▅▅▅▅▅▅▅▅▉
